%%%%%%%%%%%%%%%%%%%%%%%%%%%%%%%%%%%%%%
%P                                   %
%%%%%%%%%%%%%%%%%%%%% %%   %%%%%%%%  %
% %%       %          %%     %%      %
% %% %   % % %%%% %%%%%%%%%  %%      %
% %% %   % % %    %%         %%      %
% %% %   % % % %%%%%  %%%    %%%%%%  %
% %% %   %   %    %%  % %%%%%%%      % 
% %% %   %%%%                %%  %%%%%
% %% %   %%       %%%%%%%%%  %%      %
%    %%% %% %%%%%%%      %%  %%%%%%  %
%%%%%%      %       %    %%          %
%      %%%%%% %%%%%%%    %%  %%  %%%%%
% %%%%%%      %      %% %%%%%%%      %
%          %%%%     %%       %  %%%  %
%%%%%%%%%%%%      %         %%%%%    %
%.               %    %%%%           %
%%%%%%%%%%%%%%%%%%%%%%%%%%%%%%%%%%%%%%