%%%%%%%%%
%      .%
%  %%%% %
%.%P    %
%%%%%%%%%